 | | | | | | | | 
 | | | | | | | | 
 | | | | | | | | 
 | | | | | | | | 
1| | | | | | | |1
6|6| | | | | |6|6
10|10|20| | | |20|10|10
15|20|30| | | |30|20|15
 | | | | | | | | 
 | | | | | | | | 
50